zerco	t͡s e r k o
pur	p u r
longa	l o n g a
picio	p i tʃ o
scarti	s k a r t i
fiaca	f j a k a
spente	s p e n t e
cavai	k a v a j
so	s o
longo	l o n g o
fiapo	f j a p o
spenti	s p e n t i
qua	k w a
stanche	s t a n k e
vecio	v e t͡ʃ o
tak	t a k
si	s i
porto	p o r t o
far	f a r
spuzi	s p u t͡s i
pirla	p i r l a
finti	f i n t i
carta	k a r t a
bich	b i t͡ʃ
neutro	n e u t r o
cior	t͡ʃ o r
puk	p u k
ben	b e n
longhe	l o n g e
fiume	f j u m e
sui	s u j
picie	p i t͡ʃ e
fiapa	p j a p a
scampi	s k a m p i
plotch	p l o t͡ʃ
per	p e r
longhi	l o n g i
quindi	k w i n d i
finto	f i n t o
poco	p o k o
funghi	f u n g i
nissun	n i s u n
fiape	f j a p e
erte	e r t e
su	s u
poca	p o k a
can	k a n
picia	p i t͡ʃ a
porta	p o r t a
finte	f i n t e
spek	s p e k
fiapi	f j a p i
curta	k u r t a
pel	p e l
fior	f j o r
pal	p a l
scarto	s k a r t o
pirle	p i r l e
scampo	s k a m p o
stanca	s t a n k a
curti	k u r t i
poche	p o k e
sa	s a
carte	k a r t e
tir	t i r
fin	f i n
fungo	f u n g o
fil	f i l
vecia	v e t͡ʃ a
aquoso	a k w o s o
porte	p o r t e
punte	p u n t e
se	s e
vecio	v e t͡ʃ o
col	k o l
zerca	t͡s e r k a
pici	p i t͡ʃ i
spuzo	s p u t͡s o
cavei	k a v e j
spento	s p e n t o
cul	k u l
scrauso	s k r a u s o
curto	k u r t o
finta	f i n t o
versi	v e r s i
curte	k u r t e
quel	k w e l
spuze	s p u t͡s e
punta	p u n t a
fien	f j e n
vece	v e t͡ʃ e
fioi	f j o j
circhi	t͡ʃ i r k i
pochi	p o k i
spuza	s p u t͡s a
porto	p o r t o
spenta	s p e n t a
con	k o n
circo	t͡ʃ i r k o